...*.......%#...$
####....###.#....
####...%###.#....
.#..*.......#....
............#....
####..*.###...*..
...#..#.........%
.#%.....@...%....
######........###
....###..*..#####
....#####.%......