###################
#..%.....$.....%..#
#..*..#.###.#..*..#
#.....#*%%%*#.....#
#.....#.....#.....#
#.....#.....#.....#
#.....###.###.....#
#*......#.#......*#
#...%...#.#...%...#
#.................#
#.................#
#....%.......%....#
#.................#
#.*.............*.#
#.................#
#.................#
#....#...*...#....#
#........@........#
###################