...........................................
..%........%.....#.......*.................
.................#.........................
.........%.......#.........................
.................#................%........
...*.........##.#########..###########.....
..##...................%#.........%........
...#.....#............##################..#
...#.....#.%..........#...........%.......#
......................##########.##########
#####...........*....%#...........%........
.......########.########...................
.......#$*....#.#......#################...
*......#*.....#.#....*.......###...........
.......#......#.###..........#.............
.*.....#......#..%#.....*....#.#*..........
.......#....%.#####..........#.#...........
....*%.#.....................#%#...........
.......#................*....#.#...........
.*....@#.....%.............................